111111111
100C000N1
1P00000E1
100C00001
111111111