111111111
100000C01
10P000001
10C000E01
1N00000N1
111111111