111111111111
1E00000000N1
101001010011
101001001011
101001001011
101001001011
101001001011
101001001011
101001001011
101001001011
101001001011
101001001011
101001001011
101001001011
101001001011
101001001011
1P0000000C01
111111111111