111111111
1000000C1
111111111
1P00000E1
111111111