111111111111
1E0000000001
101001010011
101001001011
101001001011
101001001011
101001001011
101001001011
101001001011
101001001011
101001001011
101001001011
101001001011
101001001011
101001001011
101001001011
1P0000000C01
111111111111